apple - яблоко
banana - банан
grape - виноград
orange - апельсин
lemon - лимон
pear - груша
peach - персик
plum - слива
cherry - вишня
strawberry - клубника
raspberry - малина
blueberry - черника
blackberry - ежевика
pineapple - ананас
watermelon - арбуз
melon - дыня
kiwi - киви
mango - манго
papaya - папайя
avocado - авокадо
carrot - морковь
potato - картофель
tomato - помидор
cucumber - огурец
onion - лук
garlic - чеснок
pepper - перец
lettuce - салат
spinach - шпинат
broccoli - брокколи
cauliflower - цветная капуста
cabbage - капуста
peas - горох
beans - бобы
corn - кукуруза
mushroom - гриб
zucchini - кабачок
eggplant - баклажан
pumpkin - тыква
beetroot - свекла
radish - редис
turnip - репа
asparagus - спаржа
artichoke - артишок
brussels sprouts - брюссельская капуста
celery - сельдерей
chili - чили
parsley - петрушка
dill - укроп
basil - базилик
rosemary - розмарин
thyme - тимьян
oregano - орегано
sage - шалфей
coriander - кориандр
mint - мята
ginger - имбирь
turmeric - куркума
cinnamon - корица
nutmeg - мускатный орех
vanilla - ваниль
clove - гвоздика
peppercorn - перец горошком
mustard - горчица
ketchup - кетчуп
mayonnaise - майонез
butter - масло
cheese - сыр
milk - молоко
yogurt - йогурт
cream - сливки
ice cream - мороженое
bread - хлеб
bagel - бублик
croissant - круассан
muffin - маффин
donut - пончик
cookie - печенье
cake - торт
pie - пирог
pudding - пудинг
chocolate - шоколад
candy - конфета
sugar - сахар
honey - мед
jam - джем
jelly - желе
peanut butter - арахисовое масло
coffee - кофе
tea - чай
juice - сок
water - вода
soda - газировка
wine - вино
beer - пиво
whiskey - виски
vodka - водка
rum - ром
gin - джин
champagne - шампанское
cocktail - коктейль
smoothie - смузи
milkshake - молочный коктейль
soup - суп
stew - рагу
salad - салат
sandwich - сэндвич
burger - бургер
pizza - пицца
pasta - паста
spaghetti - спагетти
noodles - лапша
rice - рис
quinoa - киноа
lentils - чечевица
beans - фасоль
chicken - курица
beef - говядина
pork - свинина
lamb - баранина
fish - рыба
shrimp - креветка
lobster - омар
crab - краб
oyster - устрица
clams - моллюски
squid - кальмар
octopus - осьминог
salmon - лосось
tuna - тунец
trout - форель
sardine - сардина
anchovy - анчоус
herring - сельдь
cod - треска
halibut - палтус
mackerel - скумбрия
chili pepper - острый перец
hot dog - хот-дог
sausage - колбаса
bacon - бекон
ham - ветчина
meatball - фрикаделька
steak - стейк
chop - отбивная
rib - ребро
wing - крыло
drumstick - голень
thigh - бедро
breast - грудка
leg - нога
roast - жаркое
barbecue - барбекю
grill - гриль
fry - жарить
bake - печь
boil - варить
steam - парить
simmer - томить
stir-fry - жарить в раскаленном масле
roast - запекать
smoke - коптить
season - приправлять
marinate - мариновать
mix - смешивать
chop - нарезать
slice - нарезать ломтиками
dice - нарезать кубиками
peel - чистить
grate - тереть
knead - месить
whisk - взбивать
stir - перемешивать
pour - наливать
serve - подавать
eat - есть
drink - пить
hello - привет