баклажан - eggplant
тимьян - thyme
анчоус - anchovy
острый перец - chili pepper
вино - wine
пирог - pie
шоколад - chocolate
кориандр - coriander
запекать - roast
торт - cake
шпинат - spinach
пудинг - pudding
черника - blueberry
укроп - dill
моллюски - clams
омар - lobster
киноа - quinoa
помидор - tomato
кальмар - squid
масло - butter
гриль - grill
барбекю - barbecue
свекла - beetroot
груша - pear
ананас - pineapple
виноград - grape
тунец - tuna
рыба - fish
шампанское - champagne
лимон - lemon
приправлять - season
артишок - artichoke
бекон - bacon
сливки - cream
отбивная - chop
треска - cod
вода - water
маффин - muffin
розмарин - rosemary
пончик - doughnut
апельсин - orange
сельдь - herring
спагетти - spaghetti
огурец - cucumber
банан - banana
нога - leg
пиво - beer
кофе - coffee
лосось - salmon
куркума - turmeric
чай - tea
смузи - smoothie
стейк - steak
манго - mango
смешивать - mix
сок - juice
гвоздика - clove
бургер - burger
базилик - basil
жаркое - roast
морковь - carrot
брокколи - broccoli
авокадо - avocado
мариновать - marinate
газировка - soda
